P#########
####S##B##
#J#####B##
#######B#L
####BBBB##
#B########
#B########
#BBB##A###
##########
####BBBBB#
