P#########
####S##X##
#M#####X##
#######X#L
####XXXX##
#X########
#X########
#XXX##A###
##########
####XXXXX#
